"filename", "language", "C++", "C#", "comment", "blank", "total"
"c:\Users\KAMil\OneDrive\Documents\UE_4.25\MythsAndLegends\Source\MythsAndLegends\MythsAndLegends.Build.cs", "C#", 0, 22, 1, 4, 27
"c:\Users\KAMil\OneDrive\Documents\UE_4.25\MythsAndLegends\Source\MythsAndLegends\MythsAndLegends.cpp", "C++", 4, 0, 1, 4, 9
"c:\Users\KAMil\OneDrive\Documents\UE_4.25\MythsAndLegends\Source\MythsAndLegends\MythsAndLegends.h", "C++", 3, 0, 1, 4, 8
"c:\Users\KAMil\OneDrive\Documents\UE_4.25\MythsAndLegends\Source\MythsAndLegends\MythsAndLegendsCharacter.cpp", "C++", 72, 0, 8, 11, 91
"c:\Users\KAMil\OneDrive\Documents\UE_4.25\MythsAndLegends\Source\MythsAndLegends\MythsAndLegendsCharacter.h", "C++", 22, 0, 8, 11, 41
"c:\Users\KAMil\OneDrive\Documents\UE_4.25\MythsAndLegends\Source\MythsAndLegends\MythsAndLegendsGameMode.cpp", "C++", 13, 0, 3, 3, 19
"c:\Users\KAMil\OneDrive\Documents\UE_4.25\MythsAndLegends\Source\MythsAndLegends\MythsAndLegendsGameMode.h", "C++", 11, 0, 1, 8, 20
"c:\Users\KAMil\OneDrive\Documents\UE_4.25\MythsAndLegends\Source\MythsAndLegends\MythsAndLegendsPlayerController.cpp", "C++", 84, 0, 11, 18, 113
"c:\Users\KAMil\OneDrive\Documents\UE_4.25\MythsAndLegends\Source\MythsAndLegends\MythsAndLegendsPlayerController.h", "C++", 21, 0, 9, 14, 44
"c:\Users\KAMil\OneDrive\Documents\UE_4.25\MythsAndLegends\Source\MythsAndLegends\Private\AI_Task\AITargetPoint.cpp", "C++", 11, 0, 3, 11, 25
"c:\Users\KAMil\OneDrive\Documents\UE_4.25\MythsAndLegends\Source\MythsAndLegends\Private\AI_Task\AttackEnemy.cpp", "C++", 38, 0, 1, 10, 49
"c:\Users\KAMil\OneDrive\Documents\UE_4.25\MythsAndLegends\Source\MythsAndLegends\Private\AI_Task\IncrementPathIndex.cpp", "C++", 30, 0, 1, 11, 42
"c:\Users\KAMil\OneDrive\Documents\UE_4.25\MythsAndLegends\Source\MythsAndLegends\Private\AI_Task\MoveToPositionNode.cpp", "C++", 32, 0, 4, 10, 46
"c:\Users\KAMil\OneDrive\Documents\UE_4.25\MythsAndLegends\Source\MythsAndLegends\Private\BotTargetPoint.cpp", "C++", 1, 0, 1, 4, 6
"c:\Users\KAMil\OneDrive\Documents\UE_4.25\MythsAndLegends\Source\MythsAndLegends\Private\Characters\InventoryComponent.cpp", "C++", 67, 0, 8, 24, 99
"c:\Users\KAMil\OneDrive\Documents\UE_4.25\MythsAndLegends\Source\MythsAndLegends\Private\Characters\ML_PlayerController.cpp", "C++", 231, 0, 38, 46, 315
"c:\Users\KAMil\OneDrive\Documents\UE_4.25\MythsAndLegends\Source\MythsAndLegends\Private\Characters\NPC.cpp", "C++", 45, 0, 4, 15, 64
"c:\Users\KAMil\OneDrive\Documents\UE_4.25\MythsAndLegends\Source\MythsAndLegends\Private\Characters\PlayerCharacter.cpp", "C++", 50, 0, 5, 16, 71
"c:\Users\KAMil\OneDrive\Documents\UE_4.25\MythsAndLegends\Source\MythsAndLegends\Private\Characters\SkillComponent.cpp", "C++", 28, 0, 8, 13, 49
"c:\Users\KAMil\OneDrive\Documents\UE_4.25\MythsAndLegends\Source\MythsAndLegends\Private\Controllers\BaseAIController.cpp", "C++", 34, 0, 4, 10, 48
"c:\Users\KAMil\OneDrive\Documents\UE_4.25\MythsAndLegends\Source\MythsAndLegends\Private\Controllers\PlayerAiController.cpp", "C++", 12, 0, 1, 8, 21
"c:\Users\KAMil\OneDrive\Documents\UE_4.25\MythsAndLegends\Source\MythsAndLegends\Private\Items\BaseItem.cpp", "C++", 1, 0, 2, 3, 6
"c:\Users\KAMil\OneDrive\Documents\UE_4.25\MythsAndLegends\Source\MythsAndLegends\Private\Items\BaseWeapon.cpp", "C++", 4, 0, 1, 5, 10
"c:\Users\KAMil\OneDrive\Documents\UE_4.25\MythsAndLegends\Source\MythsAndLegends\Private\Levels\BaseLevelScript.cpp", "C++", 16, 0, 1, 6, 23
"c:\Users\KAMil\OneDrive\Documents\UE_4.25\MythsAndLegends\Source\MythsAndLegends\Private\UI\InventoryItemButton.cpp", "C++", 22, 0, 1, 4, 27
"c:\Users\KAMil\OneDrive\Documents\UE_4.25\MythsAndLegends\Source\MythsAndLegends\Private\UI\InventoryUI.cpp", "C++", 70, 0, 1, 10, 81
"c:\Users\KAMil\OneDrive\Documents\UE_4.25\MythsAndLegends\Source\MythsAndLegends\Private\UI\MainHUD.cpp", "C++", 55, 0, 10, 17, 82
"c:\Users\KAMil\OneDrive\Documents\UE_4.25\MythsAndLegends\Source\MythsAndLegends\Private\UI\SelectedInventoryItem.cpp", "C++", 46, 0, 1, 7, 54
"c:\Users\KAMil\OneDrive\Documents\UE_4.25\MythsAndLegends\Source\MythsAndLegends\Public\AI_Task\AITargetPoint.h", "C++", 16, 0, 2, 8, 26
"c:\Users\KAMil\OneDrive\Documents\UE_4.25\MythsAndLegends\Source\MythsAndLegends\Public\AI_Task\AttackEnemy.h", "C++", 12, 0, 4, 4, 20
"c:\Users\KAMil\OneDrive\Documents\UE_4.25\MythsAndLegends\Source\MythsAndLegends\Public\AI_Task\IncrementPathIndex.h", "C++", 12, 0, 4, 5, 21
"c:\Users\KAMil\OneDrive\Documents\UE_4.25\MythsAndLegends\Source\MythsAndLegends\Public\AI_Task\MoveToPositionNode.h", "C++", 12, 0, 4, 5, 21
"c:\Users\KAMil\OneDrive\Documents\UE_4.25\MythsAndLegends\Source\MythsAndLegends\Public\BotTargetPoint.h", "C++", 9, 0, 4, 5, 18
"c:\Users\KAMil\OneDrive\Documents\UE_4.25\MythsAndLegends\Source\MythsAndLegends\Public\Characters\BaseCharacter.h", "C++", 45, 0, 2, 13, 60
"c:\Users\KAMil\OneDrive\Documents\UE_4.25\MythsAndLegends\Source\MythsAndLegends\Public\Characters\InventoryComponent.h", "C++", 29, 0, 2, 16, 47
"c:\Users\KAMil\OneDrive\Documents\UE_4.25\MythsAndLegends\Source\MythsAndLegends\Public\Characters\ML_PlayerController.h", "C++", 35, 0, 8, 20, 63
"c:\Users\KAMil\OneDrive\Documents\UE_4.25\MythsAndLegends\Source\MythsAndLegends\Public\Characters\NPC.h", "C++", 43, 0, 1, 18, 62
"c:\Users\KAMil\OneDrive\Documents\UE_4.25\MythsAndLegends\Source\MythsAndLegends\Public\Characters\PlayerCharacter.h", "C++", 24, 0, 5, 16, 45
"c:\Users\KAMil\OneDrive\Documents\UE_4.25\MythsAndLegends\Source\MythsAndLegends\Public\Characters\SkillComponent.h", "C++", 42, 0, 3, 21, 66
"c:\Users\KAMil\OneDrive\Documents\UE_4.25\MythsAndLegends\Source\MythsAndLegends\Public\Controllers\BaseAIController.h", "C++", 33, 0, 5, 18, 56
"c:\Users\KAMil\OneDrive\Documents\UE_4.25\MythsAndLegends\Source\MythsAndLegends\Public\Controllers\PlayerAiController.h", "C++", 15, 0, 4, 6, 25
"c:\Users\KAMil\OneDrive\Documents\UE_4.25\MythsAndLegends\Source\MythsAndLegends\Public\Items\BaseItem.h", "C++", 59, 0, 6, 19, 84
"c:\Users\KAMil\OneDrive\Documents\UE_4.25\MythsAndLegends\Source\MythsAndLegends\Public\Items\BaseWeapon.h", "C++", 34, 0, 4, 8, 46
"c:\Users\KAMil\OneDrive\Documents\UE_4.25\MythsAndLegends\Source\MythsAndLegends\Public\Levels\BaseLevelScript.h", "C++", 16, 0, 4, 4, 24
"c:\Users\KAMil\OneDrive\Documents\UE_4.25\MythsAndLegends\Source\MythsAndLegends\Public\UI\InventoryItemButton.h", "C++", 19, 0, 4, 7, 30
"c:\Users\KAMil\OneDrive\Documents\UE_4.25\MythsAndLegends\Source\MythsAndLegends\Public\UI\InventoryUI.h", "C++", 31, 0, 4, 14, 49
"c:\Users\KAMil\OneDrive\Documents\UE_4.25\MythsAndLegends\Source\MythsAndLegends\Public\UI\MainHUD.h", "C++", 43, 0, 12, 16, 71
"c:\Users\KAMil\OneDrive\Documents\UE_4.25\MythsAndLegends\Source\MythsAndLegends\Public\UI\SelectedInventoryItem.h", "C++", 21, 0, 4, 9, 34
"Total", "-", 1573, 22, 224, 539, 2358